NO ./path_to_the_north_texture
SO ./path_to_the_south_texture
WE ./path_to_the_west_texture
EA ./path_to_the_east_texture                

F 220,100,0
C 225,30,0

1111111111111111111111111
100000000011000000000000
111100N001110000001111111
10010000000000000000000011111111
111111111011000001110000100000001
100000000011000001110111101111011
11110111111111011101000010001111
11110111111111011101010010001
110000001101010111010000100011
1000000000000000000000000000001
100000000000000011010100111111
1100000111010101111101111000111
11110111 1110101 101111010101
11111111 1111111 111111111111