NO texture/north.xpm
SO texture/south.xpm
WE texture/west.xpm
EA texture/east.xpm                

F 200 ,  200  ,100
C 100 ,200 ,100
    
     
111    
1S1
1011
10001
100001
111111    
       