NO texture/north.xpm
SO texture/south.xpm
WE texture/west.xpm
EA texture/east.xpm                

F 200 ,  200  ,100
C 100 ,200 ,100
    
     
111    
1N1
101111
100011
100001
111111    
       