NO texture/wolfenstein/red_brick.xpm
SO texture/wolfenstein/purple_stone.xpm
WE texture/wolfenstein/grey_stone.xpm
EA texture/wolfenstein/color_stone.xpm        

F 220,100,0
C 50,200,3

 111111
10100001
1010010W1
10000001
 111111