NO texture/wolfenstein/red_brick.xpm
SO texture/wolfenstein/purple_stone.xpm
WE texture/wolfenstein/grey_stone.xpm
EA texture/wolfenstein/color_stone.xpm        

F 220,100,0
C 50,200,3

11111111
101W0001
10100101
10000001
1111111