NO texture/wolfenstein/red_brick.xpm
SO texture/wolfenstein/purple_stone.xpm
WE texture/wolfenstein/grey_stone.xpm
EA texture/wolfenstein/color_stone.xpm

F 0,0,0
C 255,255,255

01111111111111111111111111110
11111111111111111111111111111
10000000000000000000000000001   1111111
010000000000000000000000000001  100001
1100000000000000000000000000N1  100001
11111111111111000000000001111   1111111
10000000000000000000000001
1111111111111111111111111